request	sentiment^request
application	sentiment^request^application
call	sentiment^request^call
appeal	sentiment^request^appeal
demand	sentiment^request^demand
inquiry	sentiment^request^inquiry
invitation	sentiment^request^invitation
link	sentiment^request^link
fill	sentiment^request^fill
form	sentiment^request^form
claim	sentiment^request^claim
petition	sentiment^request^petition
plea	sentiment^request^plea
order	sentiment^request^order
accept	sentiment^request^accept
information	sentiment^request^information
finding	sentiment^request^finding
details	sentiment^request^details
provide	sentiment^request^provide
send	sentiment^request^send
tell	sentiment^request^tell
attach	sentiment^request^attach
enquire	sentiment^request^enquire
question	sentiment^request^question
